16 16
0 1 2 4 0 1 2 4 0 1 2 4 0 1 2 4
4 0 1 2 4 0 1 2 4 0 1 2 4 0 1 2
1 3 4 2 1 3 4 2 1 3 4 2 1 3 4 2
2 0 2 1 2 0 2 1 2 0 2 1 2 0 2 1
0 1 2 4 0 1 2 4 0 1 2 4 0 1 2 4
4 0 1 2 4 0 1 2 4 0 1 2 4 0 1 2
1 3 4 2 1 3 4 2 1 3 4 2 1 3 4 2
2 0 2 1 2 0 2 1 2 0 2 1 2 0 2 1
0 1 2 4 0 1 2 4 0 1 2 4 0 1 2 4
4 0 1 2 4 0 1 2 4 0 1 2 4 0 1 2
1 3 4 2 1 3 4 2 1 3 4 2 1 3 4 2
2 0 2 1 2 0 2 1 2 0 2 1 2 0 2 1
0 1 2 4 0 1 2 4 0 1 2 4 0 1 2 4
4 0 1 2 4 0 1 2 4 0 1 2 4 0 1 2
1 3 4 2 1 3 4 2 1 3 4 2 1 3 4 2
2 0 2 1 2 0 2 1 2 0 2 1 2 0 2 1
